1111111111111
10010000000C1
1100001111001
1P0011E0000L1
1111111111111